uuuuuuuuuuuuuuuuuuuuuuuuuuuuuu
l__a___I______rl___a__a__a___r
l___a__I_a_a__rla____a__a___ar
l_a___________rl_a_a___a__a_Ir
l__a__a___a___rl__a__a___a__Ir
l___aa___a_aa_II___a___a___aIr
l_a____Ia__a__g__a___a___a___r
l______I______G___a____a___a_r
ddddddddddddddIIdddddddddddddr